*****
*CXX*
***X*
*..E*
*****
